+--+--+--+--+--+--+--+--+--+--+--+--+--+--+--+--+--+--+--+--+
 s             |        |     |                    |     |  |
+  +--+--+--+  +  +  +--+  +  +  +--+--+--+--+--+  +  +  +  +
|     |           |     |  |  |     |     |     |     |     |
+  +--+  +--+  +--+--+  +  +--+--+  +  +  +  +  +--+--+--+--+
|  |     |     |     |  |        |     |  |  |  |     |     |
+  +  +--+  +--+--+  +  +  +--+  +--+  +  +  +  +  +  +  +  +
|  |  |     |     |  |  |     |        |  |  |  |  |  |  |  |
+--+  +--+--+  +  +  +  +--+--+--+--+--+  +  +  +--+  +  +--+
|     |     |  |     |  |        |     |  |  |     |  |     |
+  +--+  +  +  +--+--+  +  +--+  +--+  +  +--+--+  +  +--+  +
|     |  |  |           |  |  |  |     |     |     |        |
+--+  +--+  +--+--+--+--+  +  +  +  +--+--+  +--+  +--+--+  +
|  |     |              |     |        |  |     |  |  |     |
+  +--+  +--+  +--+--+--+--+--+--+--+  +  +--+  +  +  +  +  +
|  |  |  |     |        |     |        |           |  |  |  |
+  +  +  +  +--+  +--+  +  +--+  +  +--+--+--+  +--+  +  +--+
|        |  |  |     |        |  |  |     |     |     |     |
+--+  +--+  +  +--+  +--+--+  +--+  +--+  +  +--+  +--+--+  +
|     |     |              |                 |  |  |  |     |
+  +--+--+  +--+--+--+--+--+--+--+  +--+  +--+  +  +  +  +  +
|        |                 |        |     |     |     |  |  |
+--+--+  +--+--+--+--+--+  +  +--+--+  +--+  +  +  +--+  +  +
|     |  |              |  |  |  |     |     |        |  |  |
+--+  +  +  +--+--+--+  +  +  +  +  +--+  +--+  +  +  +  +  +
|     |  |  |     |     |  |     |     |  |  |  |  |     |  |
+  +  +  +--+  +  +  +--+  +--+  +--+  +  +  +  +  +--+--+--+
|  |  |        |     |        |  |        |     |  |        |
+  +--+--+--+--+  +--+--+--+  +  +--+--+--+  +--+  +  +--+  +
|        |        |        |  |     |        |     |  |     |
+  +--+  +  +--+--+  +--+  +  +--+  +  +--+--+  +--+  +--+--+
|     |     |        |  |     |     |        |     |        |
+--+  +--+--+  +--+--+  +--+--+  +--+--+--+--+--+  +--+--+  +
|     |     |  |     |     |     |     |           |     |  |
+  +--+--+  +  +  +  +--+  +  +--+  +  +  +--+--+--+  +--+  +
|  |           |  |        |     |  |                 |     |
+  +  +--+  +--+  +--+  +  +  +  +  +--+  +--+--+--+  +  +--+
|     |  |     |     |  |  |  |  |     |     |     |  |  |  |
+  +--+  +--+  +--+  +  +  +  +  +--+  +--+--+  +  +  +  +  +
|        |           |  |     |     |           |  |       e 
+--+--+--+--+--+--+--+--+--+--+--+--+--+--+--+--+--+--+--+--+
