##################################################################################
#   s                                                                            #
#                                                                                #
#                                                                                #
#                                                                                #
#                                                                                #
#                ################################                                #
#                                                                                #
#                                                                                #
#                          ################################                      #
#                                                                                #
#                                                                                #
#################################                                                #
#                                                                                #
#                                                                                #
#                                       ################################         #
#                                                                                #
#                          ################################                      #
#                                                                                #
#      ################################                                          #
#                                                                                #
#                                                                                #
#                      e                                                         #
#                                                                                #
#                                                                                #
#                                                                                #
#                                                                                #
#                                                                                #
#                                                                                #
#                                                                                #
#                                                                                #
#                                                                                #
#                                                                                #
#                                                                                #
#                                                                                #
#                                                                                #
#                                                                                #
##################################################################################
